class SheetName(Enum):
	LOCATION="Location"
	LOCATIONGROUP="LocationGroup"
	LOCATIONLEGALENTITY="LocationLegalEntity"
	LOCATIONAREA="LocationArea"
	LOCATIONAREAHISTORY="LocationAreaHistory"
	LOCATIONTOPARTNER="LocationToPartner"
	LOCATIONTOPARTNERCONTACT="LocationToPartnerContact"
	OPERATINGCOSTPERIOD="OperatingCostPeriod"
	OPERATINGCOSTPERIODEXPENSE="OperatingCostPeriodExpense"
	PREMISE="Premise"
	PREMISEAREA="PremiseArea"
	PREMISEAREAHISTORY="PremiseAreaHistory"
	PREMISEGROUP="PremiseGroup"
	LEASE="Lease"
	TERMS="Terms"
	TERMAMOUNTS="TermAmounts"
	TERMVENDOR="TermVendor"
	NFSLINK="NfsLink"
	PERCENTAGERENTPERIOD="PercentageRentPeriod"
	PERCENTAGERENTEXCLUSION="PercentageRentExclusion"
	PERCENTAGERENTRULE="PercentageRentRule"
	LEASECLAUSETYPE="LeaseClauseType"
	CLAUSE="Clause"
	LEASECRITICALCLAUSETYPE="LeaseCriticalClauseType"
	CRITICALCLAUSE="CriticalClause"
	INSURANCE="Insurance"
	LEASECONDITION="LeaseCondition"
	AREABASEDPROSHARE="AreaBasedProShare"
	FIXEDPERCENTAGEPROSHARE="FixedPercentageProShare"
	FIXEDCAP="FixedCAP"
	OVERBASECAP="OverBaseCAP"
	OVERYEARCAP="OverYearCAP"
	LEASEINCENTIVE="LeaseIncentive"
	DRAW="Draw"
	USERDEFINEDFIELDS="UserDefinedFields"
	LEASEEVENT="LeaseEvent"
	DOCUMENTLINK="DocumentLink"
	NOTE="Note"
	NOTEENTITYTYPEOPTION="NoteEntityTypeOption"
	DOCUMENTENTITIES="DocumentEntities"
